BBBB****
P#S#  K##
###E#####
##P#N  ##
########R
####  ###
