NNNNNNNNNNNNNNNNNN*
K#######K
#       #
# K###K #
# #   # #
# # S # #
# # ### #
# #     #
# K#####K
#
#
#
E
