PPPP**B
S###  ####
###R######
##########
##########
   #  #
   #  #
##########
##########
##########
####  ###E
